**********
*P          *
*            *
*          *
*             *
*    M       *
*        *
*       G*
**********