**********
*P       *
*        *
*        *
*        *
*    *   *
*   *M*  *
*    *   *
*       G*
**********